11111111111111111111
10001000200010000001
10101010101010101011
10000000000000000001
11111111111111111111